{
    "question_marks" : [[9,10,"Ты почти у цели"]],
    "lava" : [[6,14],[7,14],[8,14],[13,13]],
    "keys" : [{ "x":384, "y":224, "width":32, "height":32,
        "destination_zone":"11"}],
        
    "notes" : [{ "x":96, "y":384, "width":32, "height":32, "text" : "При всем уважении, но вы не правы © Сашенька"}],

    "layers" : [
        {
            "graphical_map" : [
                309,309,309,309,309,309,309,309,309,309,309,309,309,309,309,309,
                309,309,309,309,309,309,309,309,309,309,309,309,309,309,309,309,
                309,309,309,309,309,309,309,309,309,309,309,309,309,309,309,309,
                309,309,309,309,309,309,309,309,309,309,309,309,309,309,309,309,
                309,309,309,309,309,309,309,309,309,309,309,309,309,309,309,309,
                309,309,309,309,309,309,309,309,309,309,309,309,309,309,309,309,
                309,309,309,309,309,309,309,309,309,309,309,309,309,309,309,309,
                309,309,309,309,309,309,309,309,309,309,309,309,309,309,309,309,
                309,309,309,309,309,309,309,309,309,309,309,309,309,309,309,309,
                309,309,309,309,309,309,309,309,309,309,309,309,309,309,309,309,
                309,309,309,309,309,309,309,309,309,309,309,309,309,309,309,309,
                309,309,309,309,309,309,309,309,309,309,309,309,309,309,309,309,
                309,309,309,309,309,309,309,309,309,309,309,309,309,309,309,309,
                309,309,309,309,309,309,309,309,309,309,309,309,309,309,309,309,
                309,309,309,309,309,309,309,309,309,309,309,309,309,309,309,309,
                309,309,309,309,309,309,309,309,309,309,309,309,309,309,309,309
            ],
            "inFront" : false
        },
        {
            "graphical_map" : [
                253,241,241,241,241,241,241,241,241,241,241,241,241,241,241,261,
                258,249,249,249,249,249,249,249,249,249,249,249,249,249,249,252,
                258,249,249,249,249,249,249,249,249,0,0,0,249,249,249,252,
                258,249,249,249,0,0,0,249,249,249,0,0,0,249,249,252,
                258,249,249,0,0,0,0,0,249,249,0,0,0,249,249,252,
                258,249,249,249,0,0,0,0,0,0,0,0,0,0,249,252,
                258,249,249,0,0,0,0,0,0,0,0,0,0,0,249,252,
                258,249,0,0,0,0,0,0,0,0,0,0,747,249,249,252,
                258,249,0,0,0,0,0,0,0,0,0,0,249,249,249,252,
                258,249,0,0,0,0,0,0,0,0,0,0,249,249,249,252,
                258,249,0,0,0,0,0,0,0,0,0,0,249,0,249,252,
                258,249,0,0,0,0,0,0,0,0,0,0,0,0,249,252,
                258,249,0,747,0,0,0,0,0,0,0,249,249,0,249,252,
                258,249,249,249,0,747,0,0,0,0,0,249,249,0,249,252,
                258,249,249,249,249,249,0,0,0,249,249,249,249,249,249,252,
                247,255,255,255,255,255,255,255,255,255,255,255,255,255,255,248
            ],
            "inFront" : false
        },
        {
            "graphical_map" : [
                0,0,0,0,0,0,0,0,0,0,0,0,0,0,0,0,
                0,0,0,0,0,0,0,0,0,0,0,0,0,0,0,0,
                0,0,0,0,0,0,0,0,0,0,0,0,0,0,0,0,
                0,0,0,0,0,0,0,0,0,0,0,0,0,0,0,0,
                0,0,0,0,0,0,0,0,0,0,0,0,0,0,0,0,
                0,0,0,0,0,0,0,0,0,0,0,0,0,0,0,0,
                0,0,0,0,0,0,0,0,0,0,0,0,0,0,0,0,
                0,0,0,0,0,0,439,0,0,0,0,0,0,0,0,0,
                0,0,0,0,0,0,0,0,0,0,439,0,0,0,0,0,
                0,0,0,0,0,0,0,0,0,0,0,0,0,0,0,0,
                0,0,0,0,0,0,0,0,0,0,0,0,0,0,0,0,
                0,0,0,0,0,0,0,0,439,439,0,0,0,0,0,0,
                0,0,0,0,0,0,0,0,0,0,0,0,0,0,0,0,
                0,0,0,0,0,0,439,0,0,0,0,0,0,0,0,0,
                0,0,0,0,0,0,0,0,0,0,0,0,0,0,0,0,
                0,0,0,0,0,0,0,0,0,0,0,0,0,0,0,0
            ],
            "inFront" : false
        },
        {
            "graphical_map" : [
                0,0,0,0,0,0,0,0,0,0,0,0,0,0,0,0,
                0,0,0,0,0,0,0,0,0,0,0,0,0,0,0,0,
                0,0,0,0,0,0,0,0,0,0,0,0,0,0,0,0,
                0,0,0,0,0,0,0,0,0,0,0,0,0,0,0,0,
                0,0,0,0,0,0,0,0,0,0,0,0,0,0,0,0,
                0,0,0,0,0,0,0,0,0,0,0,0,0,0,0,0,
                0,0,0,0,0,0,0,0,0,0,0,0,0,0,0,0,
                0,0,0,0,0,0,0,0,0,0,0,0,0,0,0,0,
                0,0,0,0,0,0,0,0,0,0,0,0,0,0,0,0,
                0,0,0,0,0,0,0,0,0,0,0,0,0,0,0,0,
                0,0,0,0,0,0,0,0,0,237,0,0,0,0,0,0,
                0,0,0,0,0,0,0,0,0,0,0,0,0,0,0,0,
                0,0,0,0,0,0,0,0,0,0,520,0,0,0,0,0,
                0,0,0,0,0,0,0,0,0,0,528,0,0,0,0,0,
                0,0,0,0,0,0,0,0,0,0,0,0,0,0,0,0,
                0,0,0,0,0,0,0,0,0,0,0,0,0,0,0,0
            ],
            "inFront" : false
        }
    ],

    "collision_map" : [
        15,15,15,15,15,15,15,15,15,15,15,15,15,15,15,15,
        15,15,15,15,15,15,15,15,15,15,15,15,15,15,15,15,
        15,15,15,15,15,15,15,15,15,0,0,0,15,15,15,15,
        15,15,15,15,0,0,0,15,15,15,0,0,0,15,15,15,
        15,15,15,0,0,0,0,0,15,15,0,0,0,15,15,15,
        15,15,15,15,0,0,0,0,0,0,0,0,0,0,15,15,
        15,15,15,0,0,0,0,0,0,0,0,0,0,0,15,15,
        15,15,0,0,0,0,1,0,0,0,0,0,0,15,15,15,
        15,15,0,0,0,0,0,0,0,0,1,0,15,15,15,15,
        15,15,0,0,0,0,0,0,0,0,0,0,15,15,15,15,
        15,15,0,0,0,0,0,0,0,0,0,0,15,0,15,15,
        15,15,0,0,0,0,0,0,1,1,0,0,0,0,15,15,
        15,15,0,0,0,0,0,0,0,0,0,15,15,0,15,15,
        15,15,15,15,0,0,1,0,0,0,0,15,15,0,15,15,
        15,15,15,15,15,15,0,0,0,15,15,15,15,15,15,15,
        15,15,15,15,15,15,15,15,15,15,15,15,15,15,15,15
    ],

    "doors" : [
        { "x":320, "y":384, "width":32, "height":64,
            "destination_zone":"06", "destination_x":128, "destination_y":64, "needs_key" : true, "zone" : "09"}
    ],

    "columns" : 16,
    "rows" : 16,

    "id" : "02"
}