{
    "question_marks" : [],
    "lava" : [[8,14],[9,14]],
    "keys" : [],
    "notes" : [{ "x":384, "y":416, "width":32, "height":32, "text" : "help me (кН - 27)"}],

    "layers" : [
        {
            "graphical_map" : [
                309,309,309,309,309,309,309,309,309,309,309,309,309,309,309,309,
                309,309,309,309,309,309,309,309,309,309,309,309,309,309,309,309,
                309,309,309,309,309,309,309,309,309,309,309,309,309,309,309,309,
                309,309,309,309,309,309,309,309,309,309,309,309,309,309,309,309,
                309,309,309,309,309,309,309,309,309,309,309,309,309,309,309,309,
                309,309,309,309,309,309,309,309,309,309,309,309,309,309,309,309,
                309,309,309,309,309,309,309,309,309,309,309,309,309,309,309,309,
                309,309,309,309,309,309,309,309,309,309,309,309,309,309,309,309,
                309,309,309,309,309,309,309,309,309,309,309,309,309,309,309,309,
                309,309,309,309,309,309,309,309,309,309,309,309,309,309,309,309,
                309,309,309,309,309,309,309,309,309,309,309,309,309,309,309,309,
                309,309,309,309,309,309,309,309,309,309,309,309,309,309,309,309,
                309,309,309,309,309,309,309,309,309,309,309,309,309,309,309,309,
                309,309,309,309,309,309,309,309,309,309,309,309,309,309,309,309,
                309,309,309,309,309,309,309,309,309,309,309,309,309,309,309,309,
                309,309,309,309,309,309,309,309,309,309,309,309,309,309,309,309
            ],
            "inFront" : false
        },
        {
            "graphical_map" : [
                253,241,241,241,241,241,241,241,241,241,241,241,241,241,241,261,
                258,259,259,259,259,259,259,259,259,259,259,259,259,259,259,252,
                258,259,259,259,259,259,259,259,259,259,0,0,0,0,259,252,
                258,259,259,259,259,0,0,259,259,0,0,0,0,0,259,252,
                258,259,259,0,0,0,0,259,0,0,0,0,0,0,0,0,
                258,259,259,0,0,0,0,0,0,0,0,0,0,0,259,252,
                258,259,0,0,0,0,0,0,0,0,0,0,0,0,259,252,
                258,259,0,0,0,809,0,0,0,0,0,0,0,0,259,252,
                258,259,0,0,0,0,0,0,0,0,0,0,259,259,259,252,
                258,259,0,0,0,0,0,0,0,0,0,0,259,259,259,252,
                258,259,0,0,0,0,0,0,0,0,0,0,259,259,259,252,
                258,259,0,0,0,0,0,0,0,0,0,259,259,259,259,252,
                258,259,0,0,0,0,259,259,0,0,0,259,259,0,259,252,
                258,259,0,709,0,259,259,259,0,0,709,0,709,0,259,252,
                258,259,259,259,259,259,259,259,0,0,259,259,259,259,259,252,
                247,255,255,255,255,255,255,255,255,255,255,255,255,255,255,248
            ],
            "inFront" : false
        },
        {
            "graphical_map" : [
                0,0,0,0,0,0,0,0,0,0,0,0,0,0,0,0,
                0,0,0,0,0,0,0,0,0,0,0,0,0,0,0,0,
                0,0,0,0,0,0,0,0,0,0,0,0,0,0,0,0,
                0,0,0,0,0,0,0,0,0,0,0,0,0,0,0,0,
                0,0,0,0,0,0,0,0,0,0,0,0,0,0,0,0,
                0,0,0,0,0,0,0,0,0,0,0,0,0,0,0,0,
                0,0,0,0,0,0,0,0,0,0,0,0,0,0,0,0,
                0,0,0,0,0,0,0,0,0,0,0,0,0,0,0,0,
                0,0,0,0,0,0,0,0,439,439,0,0,0,0,0,0,
                0,0,0,0,0,0,0,0,0,0,0,0,0,0,0,0,
                0,0,0,439,439,0,0,0,0,0,0,0,0,0,0,0,
                0,0,0,0,0,0,0,0,0,0,0,0,0,0,0,0,
                0,0,0,0,0,0,0,0,0,0,0,0,0,0,0,0,
                0,0,0,0,0,0,0,0,0,0,0,0,0,0,0,0,
                0,0,0,0,0,0,0,0,0,0,0,0,0,0,0,0,
                0,0,0,0,0,0,0,0,0,0,0,0,0,0,0,0
            ],
            "inFront" : false
        },
        {
            "graphical_map" : [
                0,0,0,0,0,0,0,0,0,0,0,0,0,0,0,0,
                0,0,0,0,0,0,0,0,0,0,0,0,0,0,0,0,
                0,0,0,0,0,0,0,0,0,0,0,0,0,0,0,0,
                0,0,0,0,0,0,0,0,0,0,0,0,0,0,0,0,
                0,0,0,0,0,0,0,0,0,0,0,0,0,0,0,0,
                0,0,0,0,0,0,0,0,0,0,0,0,0,0,0,0,
                0,0,0,0,0,0,0,0,0,0,0,0,0,0,0,0,
                0,0,0,0,0,0,0,0,0,0,0,0,0,0,0,0,
                0,0,0,0,0,0,0,0,0,0,0,0,0,0,0,0,
                0,0,0,0,0,0,0,0,0,0,0,0,0,0,0,0,
                0,0,0,0,0,0,520,0,0,0,0,0,0,0,0,0,
                0,0,0,0,0,0,528,0,0,0,0,0,0,0,0,0,
                0,0,0,0,0,0,0,0,0,0,0,0,0,0,0,0,
                0,0,0,0,0,0,0,0,0,0,0,0,0,0,0,0,
                0,0,0,0,0,0,0,0,0,0,0,0,0,0,0,0,
                0,0,0,0,0,0,0,0,0,0,0,0,0,0,0,0
            ],
            "inFront" : false
        }
    ],

    "collision_map" : [
        15,15,15,15,15,15,15,15,15,15,15,15,15,15,15,15,
        15,15,15,15,15,15,15,15,15,15,15,15,15,15,15,15,
        15,15,15,15,15,15,15,15,15,15,0,0,0,0,15,15,
        15,15,15,15,15,0,0,15,15,0,0,0,0,0,15,15,
        15,15,15,0,0,0,0,15,0,0,0,0,0,0,0,0,
        15,15,15,0,0,0,0,0,0,0,0,0,0,0,15,15,
        15,15,0,0,0,0,0,0,0,0,0,0,0,0,15,15,
        15,15,0,0,0,0,0,0,0,0,0,0,0,0,15,15,
        15,15,0,0,0,0,0,0,1,1,0,0,15,15,15,15,
        15,15,0,0,0,0,0,0,0,0,0,0,15,15,15,15,
        15,15,0,1,1,0,0,0,0,0,0,0,15,15,15,15,
        15,15,0,0,0,0,0,0,0,0,0,15,15,15,15,15,
        15,15,0,0,0,0,15,15,0,0,0,15,15,0,15,15,
        15,15,0,0,0,15,15,15,0,0,0,0,0,0,15,15,
        15,15,15,15,15,15,15,15,0,0,15,15,15,15,15,15,
        15,15,15,15,15,15,15,15,15,15,15,15,15,15,15,15
    ],

    "doors" : [
        { "x":496, "y":128, "width":32, "height":32,
            "destination_zone":"05", "destination_x":20, "destination_y":-1 },
        { "x":192, "y":322, "width":32, "height":64,
            "destination_zone":"02", "destination_x":480, "destination_y":416, "needs_key" : true, "zone" : "04" }
            ],

    "columns" : 16,
    "rows" : 16,

    "id" : "02"
}