{
    "question_marks" : [],
    "lava" : [[5,12],[6,12],[7,12]],
    "keys" : [],

    "layers" : [
        {
            "graphical_map" : [
                309,309,309,309,309,309,309,309,309,309,309,309,309,309,309,309,
                309,309,309,309,309,309,309,309,309,309,309,309,309,309,309,309,
                309,309,309,309,309,309,309,309,309,309,309,309,309,309,309,309,
                309,309,309,309,309,309,309,309,309,309,309,309,309,309,309,309,
                309,309,309,309,309,309,309,309,309,309,309,309,309,309,309,309,
                309,309,309,309,309,309,309,309,309,309,309,309,309,309,309,309,
                309,309,309,309,309,309,309,309,309,309,309,309,309,309,309,309,
                309,309,309,309,309,309,309,309,309,309,309,309,309,309,309,309,
                309,309,309,309,309,309,309,309,309,309,309,309,309,309,309,309,
                309,309,309,309,309,309,309,309,309,309,309,309,309,309,309,309,
                309,309,309,309,309,309,309,309,309,309,309,309,309,309,309,309,
                309,309,309,309,309,309,309,309,309,309,309,309,309,309,309,309,
                309,309,309,309,309,309,309,309,309,309,309,309,309,309,309,309,
                309,309,309,309,309,309,309,309,309,309,309,309,309,309,309,309,
                309,309,309,309,309,309,309,309,309,309,309,309,309,309,309,309,
                309,309,309,309,309,309,309,309,309,309,309,309,309,309,309,309
            ],
            "inFront" : false
        },
        {
            "graphical_map" : [
                253,241,241,241,241,241,241,241,241,241,241,241,241,241,241,261,
                258,259,259,259,259,259,259,259,259,259,259,259,259,259,259,252,
                258,259,259,259,259,259,0,0,0,0,0,0,0,0,259,252,
                258,259,259,259,0,0,0,0,0,0,0,0,0,0,259,252,
                258,259,0,0,0,0,0,0,0,0,0,0,0,0,259,252,
                258,259,0,0,0,0,0,0,0,0,0,0,0,0,259,252,
                0,0,0,0,0,0,0,0,0,0,0,0,0,0,0,0,
                258,259,259,0,0,0,0,0,0,0,0,0,0,0,259,252,
                258,259,259,0,0,0,0,0,0,0,0,0,0,259,259,252,
                258,259,0,0,0,0,0,0,0,0,0,0,0,259,259,252,
                258,259,0,0,0,0,0,0,0,0,0,0,0,259,259,252,
                258,259,0,0,709,0,0,0,709,0,0,0,0,259,259,252,
                258,259,0,259,259,0,0,0,259,0,0,709,0,259,259,252,
                258,259,259,259,259,259,259,259,259,259,259,259,0,259,259,252,
                258,259,259,259,259,259,259,259,259,259,259,259,259,259,259,252,
                247,255,255,255,255,255,255,255,255,255,255,255,255,255,255,248
            ],
            "inFront" : false
        },
        {
            "graphical_map" : [
                0,0,0,0,0,0,0,0,0,0,0,0,0,0,0,0,
                0,0,0,0,0,0,0,0,0,0,0,0,0,0,0,0,
                0,0,0,0,0,0,0,0,0,0,0,0,0,0,0,0,
                0,0,0,0,0,0,0,0,0,0,0,0,0,0,0,0,
                0,0,0,0,0,0,0,0,0,439,0,0,0,0,0,0,
                0,0,0,0,0,0,0,0,0,0,0,0,0,0,0,0,
                0,0,0,0,0,0,0,0,0,0,0,0,0,0,0,0,
                0,0,0,0,439,0,0,0,0,0,0,0,0,0,0,0,
                0,0,0,0,0,0,0,0,439,0,0,0,0,0,0,0,
                0,0,0,0,0,0,0,0,0,0,439,0,0,0,0,0,
                0,0,0,0,0,439,0,0,0,0,0,0,0,0,0,0,
                0,0,0,0,0,0,0,0,0,0,0,0,0,0,0,0,
                0,0,0,0,0,0,0,0,0,0,0,0,0,0,0,0,
                0,0,0,0,0,0,0,0,0,0,0,0,0,0,0,0,
                0,0,0,0,0,0,0,0,0,0,0,0,0,0,0,0,
                0,0,0,0,0,0,0,0,0,0,0,0,0,0,0,0
            ],
            "inFront" : false
        },
        {
            "graphical_map" : [
                0,0,0,0,0,0,0,0,0,0,0,0,0,0,0,0,
                0,0,0,0,0,0,0,0,0,0,0,0,0,0,0,0,
                0,0,0,0,0,0,0,0,0,0,0,0,0,0,0,0,
                0,0,0,0,0,0,0,0,0,0,0,0,0,0,0,0,
                0,0,0,0,0,0,0,0,0,0,0,0,0,0,0,0,
                0,0,0,0,0,0,0,0,0,0,0,0,0,0,0,0,
                0,0,0,0,0,0,0,0,0,0,0,0,0,0,0,0,
                0,0,0,0,0,0,0,0,0,0,0,0,0,0,0,0,
                0,0,0,0,0,0,0,0,0,0,0,0,0,0,0,0,
                0,0,0,0,0,0,0,0,0,0,0,0,0,0,0,0,
                0,0,0,0,0,0,0,0,0,0,0,0,0,0,0,0,
                0,0,0,0,0,0,0,0,0,0,0,0,0,0,0,0,
                0,0,0,0,0,0,0,0,0,0,0,0,0,0,0,0,
                0,0,0,0,0,0,0,0,0,0,0,0,0,0,0,0,
                0,0,0,0,0,0,0,0,0,0,0,0,0,0,0,0,
                0,0,0,0,0,0,0,0,0,0,0,0,0,0,0,0
            ],
            "inFront" : false
        }
    ],

    "collision_map" : [
        15,15,15,15,15,15,15,15,15,15,15,15,15,15,15,15,
        15,15,15,15,15,15,15,15,15,15,15,15,15,15,15,15,
        15,15,15,15,15,15,0,0,0,0,0,0,0,0,15,15,
        15,15,15,15,0,0,0,0,0,0,0,0,0,0,15,15,
        15,15,0,0,0,0,0,0,0,1,0,0,0,0,15,15,
        15,15,0,0,0,0,0,0,0,0,0,0,0,0,15,15,
        0,0,0,0,0,0,0,0,0,0,0,0,0,0,0,0,
        15,15,15,0,1,0,0,0,0,0,0,0,0,0,15,15,
        15,15,15,0,0,0,0,0,1,0,0,0,0,15,15,15,
        15,15,0,0,0,0,0,0,0,0,1,0,0,15,15,15,
        15,15,0,0,0,1,0,0,0,0,0,0,0,15,15,15,
        15,15,0,0,0,0,0,0,0,0,0,0,0,15,15,15,
        15,15,0,15,15,0,0,0,15,0,0,0,0,15,15,15,
        15,15,15,15,15,15,15,15,15,15,15,15,0,15,15,15,
        15,15,15,15,15,15,15,15,15,15,15,15,15,15,15,15,
        15,15,15,15,15,15,15,15,15,15,15,15,15,15,15,15
    ],

    "doors" : [{ "x":-16, "y":192, "width":32, "height":32,
        "destination_zone":"08", "destination_x":490, "destination_y":-1 },
        { "x":496, "y":192, "width":32, "height":32,
            "destination_zone":"06", "destination_x":20, "destination_y":-1 }],

    "columns" : 16,
    "rows" : 16,

    "id" : "02"
}