{
    "question_marks" : [],
    "lava" : [],
    "keys" : [],

    "layers" : [
        {
            "graphical_map" : [
                309,309,309,309,309,309,309,309,309,309,309,309,309,309,309,309,
                309,309,309,309,309,309,309,309,309,309,309,309,309,309,309,309,
                309,309,309,309,309,309,309,309,309,309,309,309,309,309,309,309,
                309,309,309,309,309,309,309,309,309,309,309,309,309,309,309,309,
                309,309,309,309,309,309,309,309,309,309,309,309,309,309,309,309,
                309,309,309,309,309,309,309,309,309,309,309,309,309,309,309,309,
                309,309,309,309,309,309,309,309,309,309,309,309,309,309,309,309,
                309,309,309,309,309,309,309,309,309,309,309,309,309,309,309,309,
                309,309,309,309,309,309,309,309,309,309,309,309,309,309,309,309,
                309,309,309,309,309,309,309,309,309,309,309,309,309,309,309,309,
                309,309,309,309,309,309,309,309,309,309,309,309,309,309,309,309,
                309,309,309,309,309,309,309,309,309,309,309,309,309,309,309,309,
                309,309,309,309,309,309,309,309,309,309,309,309,309,309,309,309,
                309,309,309,309,309,309,309,309,309,309,309,309,309,309,309,309,
                309,309,309,309,309,309,309,309,309,309,309,309,309,309,309,309,
                309,309,309,309,309,309,309,309,309,309,309,309,309,309,309,309
            ],
            "inFront" : false
        },
        {
            "graphical_map" : [
                253,241,241,241,241,241,241,241,241,241,241,241,241,241,241,261,
258,249,249,249,249,249,249,249,249,249,249,249,249,249,249,252,
258,249,0,0,0,0,249,249,249,249,249,249,249,0,249,252,
258,249,249,249,249,0,0,0,249,249,0,0,0,0,249,252,
258,249,249,249,249,0,0,0,0,0,0,0,0,0,249,252,
258,249,249,0,0,0,0,0,0,0,0,0,0,249,249,252,
258,249,0,0,0,0,629,0,0,0,747,0,249,249,249,252,
0,0,0,0,0,0,637,0,0,0,249,249,249,249,249,252,
258,249,0,0,0,0,0,0,0,0,0,249,249,0,249,252,
258,249,0,0,0,0,0,0,0,0,0,0,0,0,249,252,
258,249,0,747,0,0,0,0,0,0,0,0,0,0,249,252,
258,249,249,249,0,0,0,0,0,0,0,0,0,0,0,252,
258,249,249,249,249,249,747,0,0,0,0,0,0,0,0,252,
258,249,249,249,249,249,249,0,0,747,0,0,0,0,0,252,
258,249,249,249,249,249,249,249,249,249,0,0,0,249,249,252,
247,255,255,255,255,255,255,255,255,0,0,0,255,255,255,248
            ],
            "inFront" : false
        },
        {
            "graphical_map" : [
                0,0,0,0,0,0,0,0,0,0,0,0,0,0,0,0,
                0,0,0,0,0,0,0,0,0,0,0,0,0,0,0,0,
                0,0,0,0,0,0,0,0,0,0,0,0,0,0,0,0,
                0,0,0,0,0,0,0,0,0,0,0,0,0,0,0,0,
                0,0,0,0,0,0,0,0,0,0,0,0,0,0,0,0,
                0,0,0,0,0,439,439,0,0,0,0,0,0,0,0,0,
                0,0,0,0,0,0,0,0,0,0,0,0,0,0,0,0,
                0,0,0,0,0,0,0,0,0,0,0,0,0,0,0,0,
                0,0,0,0,0,0,0,0,0,0,0,0,0,0,0,0,
                0,0,0,0,0,0,439,439,0,0,0,0,0,0,0,0,
                0,0,0,0,0,0,0,0,0,0,0,0,0,0,0,0,
                0,0,0,0,0,0,0,0,0,0,0,0,0,0,0,0,
                0,0,0,0,0,0,0,0,0,0,0,0,0,0,0,0,
                0,0,0,0,0,0,0,0,0,0,0,0,0,0,0,0,
                0,0,0,0,0,0,0,0,0,0,0,0,0,0,0,0,
                0,0,0,0,0,0,0,0,0,0,0,0,0,0,0,0
            ],
            "inFront" : false
        },
        {
            "graphical_map" : [
                0,0,0,0,0,0,0,0,0,0,0,0,0,0,0,0,
                0,0,0,0,0,0,0,0,0,0,0,0,0,0,0,0,
                0,0,0,0,0,0,0,0,0,0,0,0,0,0,0,0,
                0,0,0,0,0,0,0,0,0,0,0,0,0,0,0,0,
                0,0,0,0,0,0,0,0,0,0,0,0,0,0,0,0,
                0,0,0,0,0,0,0,0,0,0,0,0,0,0,0,0,
                0,0,0,0,0,0,0,0,0,0,0,0,0,0,0,0,
                0,0,0,0,0,0,0,0,0,0,0,0,0,0,0,0,
                0,0,0,0,0,0,0,0,0,0,0,0,0,0,0,0,
                0,0,0,0,0,0,0,0,0,0,0,0,0,0,0,0,
                0,0,0,0,0,0,0,0,0,0,0,0,0,0,0,0,
                0,0,0,0,0,0,0,0,0,0,0,0,0,0,0,0,
                0,0,0,0,0,0,0,0,0,0,0,0,0,520,0,0,
                0,0,0,0,0,0,0,0,0,0,0,0,0,528,0,0,
                0,0,0,0,0,0,0,0,0,0,0,0,0,0,0,0,
                0,0,0,0,0,0,0,0,0,0,0,0,0,0,0,0
            ],
            "inFront" : false
        }
    ],

    "collision_map" : [
        15,15,15,15,15,15,15,15,15,15,15,15,15,15,15,15,
15,15,15,15,15,15,15,15,15,15,15,15,15,15,15,15,
15,15,0,0,0,0,15,15,15,15,15,15,15,0,15,15,
15,15,15,15,15,0,0,0,15,15,0,0,0,0,15,15,
15,15,15,15,15,0,0,0,0,0,0,0,0,0,15,15,
15,15,15,0,0,1,1,0,0,0,0,0,0,15,15,15,
15,15,0,0,0,0,0,0,0,0,0,0,15,15,15,15,
0,0,0,0,0,0,0,0,0,0,15,15,15,15,15,15,
15,15,0,0,0,0,0,0,0,0,0,15,15,0,15,15,
15,15,0,0,0,0,1,1,0,0,0,0,0,0,15,15,
15,15,0,0,0,0,0,0,0,0,0,0,0,0,15,15,
15,15,15,15,0,0,0,0,0,0,0,0,0,0,0,15,
15,15,15,15,15,15,0,0,0,0,0,0,0,0,0,15,
15,15,15,15,15,15,15,0,0,0,0,0,0,0,0,15,
15,15,15,15,15,15,15,15,15,15,0,0,0,15,15,15,
15,15,15,15,15,15,15,15,15,0,0,0,15,15,15,15
    ],

    "doors" : [{ "x":-16, "y":224, "width":32, "height":32,
        "destination_zone":"01", "destination_x":480, "destination_y":-1 },
        { "x":288, "y":496, "width":96, "height":32,
            "destination_zone":"03", "destination_x":300, "destination_y":20 },
        { "x":416, "y":384, "width":32, "height":64,
            "destination_zone":"04", "destination_x":256, "destination_y":352, "needs_key" : true, "zone" : "02" }],

    "columns" : 16,
    "rows" : 16,

    "id" : "02"
}