{
    "question_marks" : [],
    "lava" : [[3,14],[4,14],[5,14],[11,13],[12,13],[13,13]],
    "keys" : [{ "x":64, "y":352, "width":32, "height":32,
        "destination_zone":"09"}],

    "layers" : [
        {
            "graphical_map" : [
                309,309,309,309,309,309,309,309,309,309,309,309,309,309,309,309,
                309,309,309,309,309,309,309,309,309,309,309,309,309,309,309,309,
                309,309,309,309,309,309,309,309,309,309,309,309,309,309,309,309,
                309,309,309,309,309,309,309,309,309,309,309,309,309,309,309,309,
                309,309,309,309,309,309,309,309,309,309,309,309,309,309,309,309,
                309,309,309,309,309,309,309,309,309,309,309,309,309,309,309,309,
                309,309,309,309,309,309,309,309,309,309,309,309,309,309,309,309,
                309,309,309,309,309,309,309,309,309,309,309,309,309,309,309,309,
                309,309,309,309,309,309,309,309,309,309,309,309,309,309,309,309,
                309,309,309,309,309,309,309,309,309,309,309,309,309,309,309,309,
                309,309,309,309,309,309,309,309,309,309,309,309,309,309,309,309,
                309,309,309,309,309,309,309,309,309,309,309,309,309,309,309,309,
                309,309,309,309,309,309,309,309,309,309,309,309,309,309,309,309,
                309,309,309,309,309,309,309,309,309,309,309,309,309,309,309,309,
                309,309,309,309,309,309,309,309,309,309,309,309,309,309,309,309,
                309,309,309,309,309,309,309,309,309,309,309,309,309,309,309,309
            ],
            "inFront" : false
        },
        {
            "graphical_map" : [
                253,241,0,0,241,241,241,241,241,241,241,241,241,241,241,261,
                258,249,0,0,249,249,249,249,249,249,249,249,249,249,249,252,
                258,249,0,0,0,0,0,0,0,0,0,0,0,249,249,252,
                258,249,0,0,0,0,0,0,0,0,0,0,0,0,249,252,
                258,249,0,0,0,0,0,0,0,0,0,0,0,0,249,252,
                258,249,0,0,0,0,0,0,0,0,0,0,0,0,249,252,
                258,249,0,0,0,0,0,0,0,0,0,0,0,0,0,0,
                258,249,0,0,0,0,0,747,0,0,0,0,0,0,249,252,
                258,249,0,0,0,0,249,249,0,0,0,0,0,0,249,252,
                258,249,0,0,0,0,0,0,0,0,249,249,0,0,249,252,
                258,249,0,0,0,0,0,0,0,0,0,0,0,0,249,252,
                258,249,747,0,0,0,0,0,0,0,0,0,0,0,249,252,
                258,249,249,0,0,0,0,249,249,249,747,0,0,0,249,252,
                258,249,249,0,0,0,249,249,249,249,249,0,0,0,249,252,
                258,249,249,0,0,0,249,249,249,249,249,249,249,249,249,252,
                247,255,255,255,255,255,255,255,255,255,255,255,255,255,255,248
            ],
            "inFront" : false
        },
        {
            "graphical_map" : [
                0,0,0,0,0,0,0,0,0,0,0,0,0,0,0,0,
                0,0,0,0,0,0,0,0,0,0,0,0,0,0,0,0,
                0,0,439,0,0,0,0,0,0,0,0,0,0,0,0,0,
                0,0,0,0,0,0,0,0,0,0,0,0,0,0,0,0,
                0,0,0,0,0,0,0,0,0,0,0,0,0,0,0,0,
                0,0,0,0,439,0,0,0,0,0,0,0,0,0,0,0,
                0,0,0,0,0,0,0,0,0,0,0,0,0,0,0,0,
                0,0,439,0,0,0,0,0,0,0,0,0,0,0,0,0,
                0,0,0,0,0,0,0,0,0,439,439,0,0,0,0,0,
                0,0,0,0,0,0,0,0,0,0,0,0,0,0,0,0,
                0,0,0,0,0,0,0,0,0,0,0,0,0,0,0,0,
                0,0,0,0,0,0,0,0,0,0,0,0,0,0,0,0,
                0,0,0,0,0,0,0,0,0,0,0,0,0,0,0,0,
                0,0,0,0,0,0,0,0,0,0,0,0,0,0,0,0,
                0,0,0,0,0,0,0,0,0,0,0,0,0,0,0,0,
                0,0,0,0,0,0,0,0,0,0,0,0,0,0,0,0
            ],
            "inFront" : false
        },
        {
            "graphical_map" : [
                0,0,0,0,0,0,0,0,0,0,0,0,0,0,0,0,
                0,0,0,0,0,0,0,0,0,0,0,0,0,0,0,0,
                0,0,0,0,0,0,0,0,0,0,0,0,0,0,0,0,
                0,0,0,0,0,0,0,0,0,0,0,0,0,0,0,0,
                0,0,0,0,0,0,0,0,0,0,0,0,0,0,0,0,
                0,0,0,0,0,0,0,0,0,0,0,0,0,0,0,0,
                0,0,0,0,0,0,0,0,0,0,0,0,0,0,0,0,
                0,0,0,0,0,0,0,0,0,0,0,0,0,0,0,0,
                0,0,0,0,0,0,0,0,0,0,0,0,0,0,0,0,
                0,0,0,0,0,0,0,0,0,0,0,0,0,0,0,0,
                0,0,0,0,0,0,0,0,0,0,0,0,0,0,0,0,
                0,0,0,0,0,0,0,0,0,0,0,0,0,0,0,0,
                0,0,0,0,0,0,0,0,0,0,0,0,0,0,0,0,
                0,0,0,0,0,0,0,0,0,0,0,0,0,0,0,0,
                0,0,0,0,0,0,0,0,0,0,0,0,0,0,0,0,
                0,0,0,0,0,0,0,0,0,0,0,0,0,0,0,0
            ],
            "inFront" : false
        }
    ],

    "collision_map" : [
        15,15,0,0,15,15,15,15,15,15,15,15,15,15,15,15,
        15,15,0,0,15,15,15,15,15,15,15,15,15,15,15,15,
        15,15,1,0,0,0,0,0,0,0,0,0,0,15,15,15,
        15,15,0,0,0,0,0,0,0,0,0,0,0,0,15,15,
        15,15,0,0,0,0,0,0,0,0,0,0,0,0,15,15,
        15,15,0,0,1,0,0,0,0,0,0,0,0,0,15,15,
        15,15,0,0,0,0,0,0,0,0,0,0,0,0,0,0,
        15,15,1,0,0,0,0,0,0,0,0,0,0,0,15,15,
        15,15,0,0,0,0,15,15,0,1,1,0,0,0,15,15,
        15,15,0,0,0,0,0,0,0,0,15,15,0,0,15,15,
        15,15,0,0,0,0,0,0,0,0,0,0,0,0,15,15,
        15,15,0,0,0,0,0,0,0,0,0,0,0,0,15,15,
        15,15,15,0,0,0,0,15,15,15,0,0,0,0,15,15,
        15,15,15,0,0,0,15,15,15,15,15,0,0,0,15,15,
        15,15,15,0,0,0,15,15,15,15,15,15,15,15,15,15,
        15,15,15,15,15,15,15,15,15,15,15,15,15,15,15,15
    ],

    "doors" : [{ "x":64, "y":-16, "width":64, "height":32,
        "destination_zone":"10", "destination_x":-1, "destination_y":450 },
        { "x":496, "y":192, "width":32, "height":32,
            "destination_zone":"07", "destination_x":20, "destination_y":-1 }],

    "columns" : 16,
    "rows" : 16,

    "id" : "02"
}