{
    "question_marks" : [],
    "lava" : [[11,14]],
    "keys" : [],
    "player_x": 200,
    "player_y": 200,
    "notes" : [{ "x":384, "y":384, "width":32, "height":32, "text" : "я зам старосты?! не не не я прост его заменяю"}],

    "layers" : [
        {
            "graphical_map" : [
                309,309,309,309,309,309,309,309,309,309,309,309,309,309,309,309,
                309,309,309,309,309,309,309,309,309,309,309,309,309,309,309,309,
                309,309,309,309,309,309,309,309,309,309,309,309,309,309,309,309,
                309,309,309,309,309,309,309,309,309,309,309,309,309,309,309,309,
                309,309,309,309,309,309,309,309,309,309,309,309,309,309,309,309,
                309,309,309,309,309,309,309,309,309,309,309,309,309,309,309,309,
                309,309,309,309,309,309,309,309,309,309,309,309,309,309,309,309,
                309,309,309,309,309,309,309,309,309,309,309,309,309,309,309,309,
                309,309,309,309,309,309,309,309,309,309,309,309,309,309,309,309,
                309,309,309,309,309,309,309,309,309,309,309,309,309,309,309,309,
                309,309,309,309,309,309,309,309,309,309,309,309,309,309,309,309,
                309,309,309,309,309,309,309,309,309,309,309,309,309,309,309,309,
                309,309,309,309,309,309,309,309,309,309,309,309,309,309,309,309,
                309,309,309,309,309,309,309,309,309,309,309,309,309,309,309,309,
                309,309,309,309,309,309,309,309,309,309,309,309,309,309,309,309,
                309,309,309,309,309,309,309,309,309,309,309,309,309,309,309,309
            ],
            "inFront" : false
        },
        {
            "graphical_map" : [
                253,241,241,241,241,241,241,241,241,241,241,241,241,241,241,261,
                258,249,249,249,249,249,249,249,249,249,249,249,249,249,249,252,
                258,249,0,249,249,249,249,249,0,249,249,249,249,0,249,252,
                258,249,0,0,249,249,249,0,0,249,249,0,0,0,249,252,
                258,249,0,0,0,0,0,0,0,0,0,0,0,0,249,252,
                258,249,0,0,0,0,0,0,0,0,0,0,0,0,0,252,
                258,249,0,0,0,0,0,0,0,0,0,0,0,0,0,252,
                258,249,249,0,0,0,0,0,0,0,0,0,249,249,249,252,
                258,249,249,0,0,0,0,0,0,0,0,249,249,249,249,252,
                258,249,249,0,0,0,0,0,0,0,0,0,0,249,249,252,
                258,249,249,0,0,0,0,0,0,0,747,0,0,249,249,252,
                258,249,0,0,747,0,0,0,0,249,249,0,0,249,249,252,
                258,0,0,249,249,0,0,747,0,249,249,0,747,249,249,252,
                258,0,0,249,249,0,0,249,249,249,249,0,249,249,249,252,
                258,249,249,249,249,249,249,249,249,249,249,0,249,249,249,252,
                247,255,255,255,255,255,255,255,255,255,255,255,255,255,255,248
            ],
            "inFront" : false
        },
        {
            "graphical_map" : [
                0,0,0,0,0,0,0,0,0,0,0,0,0,0,0,0,
                0,0,0,0,0,0,0,0,0,0,0,0,0,0,0,0,
                0,0,0,0,0,0,0,0,0,0,0,0,0,0,0,0,
                0,0,0,0,0,0,0,0,0,0,0,0,0,0,0,0,
                0,0,0,0,0,0,0,0,0,0,0,0,0,0,0,0,
                0,0,0,0,0,0,0,0,439,439,0,0,0,0,0,0,
                0,0,0,0,0,0,0,0,0,0,0,0,0,0,0,0,
                0,0,0,0,0,0,0,0,0,0,0,0,0,0,0,0,
                0,0,0,0,439,439,439,439,0,0,0,0,0,0,0,0,
                0,0,0,0,0,0,0,0,0,0,0,0,0,0,0,0,
                0,0,0,0,0,0,0,0,0,0,0,0,0,0,0,0,
                0,0,0,0,0,0,439,439,0,0,0,0,0,0,0,0,
                0,0,0,0,0,0,0,0,0,0,0,0,0,0,0,0,
                0,0,0,0,0,0,0,0,0,0,0,0,0,0,0,0,
                0,0,0,0,0,0,0,0,0,0,0,0,0,0,0,0,
                0,0,0,0,0,0,0,0,0,0,0,0,0,0,0,0
            ],
            "inFront" : false
        },
        {
            "graphical_map" : [
                0,0,0,0,0,0,0,0,0,0,0,0,0,0,0,0,
                0,0,0,0,0,0,0,0,0,0,0,0,0,0,0,0,
                0,0,0,0,0,0,0,0,0,0,0,0,0,0,0,0,
                0,0,0,0,0,0,0,0,0,0,0,0,0,0,0,0,
                0,0,0,0,0,0,0,0,0,0,0,0,0,0,0,0,
                0,0,520,0,0,0,0,0,0,0,0,0,0,0,0,0,
                0,0,528,0,0,0,0,0,0,0,0,0,0,0,0,0,
                0,0,0,0,0,0,0,0,0,0,0,0,0,0,0,0,
                0,0,0,0,0,0,0,0,0,0,0,0,0,0,0,0,
                0,0,0,0,0,0,0,0,0,0,0,0,0,0,0,0,
                0,0,0,0,0,0,0,0,0,0,0,0,0,0,0,0,
                0,0,0,0,0,0,0,0,0,0,0,0,0,0,0,0,
                0,392,0,0,0,0,0,0,0,0,0,0,0,0,0,0,
                0,400,0,0,0,0,0,0,0,0,0,0,0,0,0,0,
                0,0,0,0,0,0,0,0,0,0,0,0,0,0,0,0,
                0,0,0,0,0,0,0,0,0,0,0,0,0,0,0,0
            ],
            "inFront" : false
        }
    ],

    "collision_map" : [
        15,15,15,15,15,15,15,15,15,15,15,15,15,15,15,15,
        15,15,15,15,15,15,15,15,15,15,15,15,15,15,15,15,
        15,15,0,15,15,15,15,15,0,15,15,15,15,0,15,15,
        15,15,0,0,15,15,15,0,0,15,15,0,0,0,15,15,
        15,15,0,0,0,0,0,0,0,0,0,0,0,0,15,15,
        15,15,0,0,0,0,0,0,1,1,0,0,0,0,0,15,
        15,15,0,0,0,0,0,0,0,0,0,0,0,0,0,15,
        15,15,15,0,0,0,0,0,0,0,0,0,15,15,15,15,
        15,15,15,0,1,1,1,1,0,0,0,15,15,15,15,15,
        15,15,15,0,0,0,0,0,0,0,0,0,0,15,15,15,
        15,15,15,0,0,0,0,0,0,0,0,0,0,15,15,15,
        15,15,0,0,0,0,1,1,0,15,15,0,0,15,15,15,
        15,0,0,15,15,0,0,0,0,15,15,0,0,15,15,15,
        15,0,0,15,15,0,0,15,15,15,15,0,15,15,15,15,
        15,15,15,15,15,15,15,15,15,15,15,0,15,15,15,15,
        15,15,15,15,15,15,15,15,15,15,15,15,15,15,15,15
    ],

    "doors" : [
        { "x":64, "y":160, "width":32, "height":64,
            "destination_zone":"10", "destination_x":128, "destination_y":160, "needs_key" : true, "zone" : "11"},
        { "x":32, "y":384, "width":32, "height":64,
            "destination_zone":"complete", "destination_x":128, "destination_y":160, "needs_key" : false, "zone" : "11"}],

    "columns" : 16,
    "rows" : 16,

    "id" : "02"
}