{
    "player_x": 200,
    "player_y": 200,
    "question_marks" : [[6,13,"Здравствуй, политехник. Ты попал в хим корпус. Никто не ожидал, но двери захлопнулись (такое бывает) и теперь, чтобы не опоздать на вышмат, тебе нужно выбраться отсюда как можно скорее! Это редко кому удавалось до тебя, но что поделать, ведь двери захлопнулись как ни как ("]],
    "lava" : [],
    "keys" : [],

    "layers" : [
        {
            "graphical_map" : [309,309,309,309,309,309,309,309,309,309,309,309,309,309,309,309,
                309,309,309,309,309,309,309,309,309,309,309,309,309,309,309,309,
                309,309,309,309,309,309,309,309,309,309,309,309,309,309,309,309,
                309,309,309,309,309,309,309,309,309,309,309,309,309,309,309,309,
                309,309,309,309,309,309,309,309,309,309,309,309,309,309,309,309,
                309,309,309,309,309,309,309,309,309,309,309,309,309,309,309,309,
                309,309,309,309,309,309,309,309,309,309,309,309,309,309,309,309,
                309,309,309,309,309,309,309,309,309,309,309,309,309,309,309,309,
                309,309,309,309,309,309,309,309,309,309,309,309,309,309,309,309,
                309,309,309,309,309,309,309,309,309,309,309,309,309,309,309,309,
                309,309,309,309,309,309,309,309,309,309,309,309,309,309,309,309,
                309,309,309,309,309,309,309,309,309,309,309,309,309,309,309,309,
                309,309,309,309,309,309,309,309,309,309,309,309,309,309,309,309,
                309,309,309,309,309,309,309,309,309,309,309,309,309,309,309,309,
                309,309,309,309,309,309,309,309,309,309,309,309,309,309,309,309,
                309,309,309,309,309,309,309,309,309,309,309,309,309,309,309,309],
            "inFront" : false
        },
        {
            "graphical_map" : [
                253,241,241,241,241,241,241,241,241,0,0,0,0,241,241,261,
258,249,249,249,249,249,249,249,249,0,0,0,0,249,249,252,
258,249,0,0,0,0,0,0,0,0,0,0,0,0,249,252,
258,249,0,0,0,0,0,0,0,0,0,0,0,0,249,252,
258,249,0,0,0,0,0,0,0,0,0,0,0,0,249,252,
258,249,0,0,0,0,0,0,0,0,0,0,0,0,249,252,
258,249,0,0,0,0,0,0,0,0,0,0,0,0,249,252,
258,249,0,0,0,0,629,0,0,0,0,0,0,0,249,252,
258,249,0,0,0,0,637,0,0,0,0,0,0,0,249,252,
258,249,0,0,0,0,0,0,0,0,0,0,0,0,249,252,
258,249,0,0,0,0,0,0,0,0,0,0,0,0,249,252,
258,249,0,0,0,0,0,0,0,0,0,0,0,0,249,252,
258,249,0,0,0,0,0,0,0,0,0,0,0,0,249,252,
258,249,0,0,0,0,0,0,0,0,0,0,0,0,249,252,
258,249,249,249,249,249,249,249,249,249,249,249,249,249,249,252,
247,255,255,255,255,255,255,255,255,255,255,255,255,255,255,248
            ],
            "inFront" : false
        },
        {
            "graphical_map" : [
                0,0,0,0,0,0,0,0,0,0,0,0,0,0,0,0,
0,0,0,0,0,0,0,0,0,0,0,0,0,0,0,0,
0,0,0,0,0,0,0,0,0,0,439,439,0,0,0,0,
0,0,0,0,0,0,0,0,0,0,0,0,0,0,0,0,
0,0,0,0,0,0,0,439,439,0,0,0,0,0,0,0,
0,0,0,0,0,0,0,0,0,0,0,0,0,0,0,0,
0,0,0,0,0,0,0,0,0,0,439,439,0,0,0,0,
0,0,0,0,0,0,0,0,0,0,0,0,0,0,0,0,
0,0,0,0,0,0,0,0,0,0,0,0,0,0,0,0,
0,0,0,0,0,0,0,0,0,0,439,439,0,0,0,0,
0,0,0,0,0,0,0,0,0,0,0,0,0,0,0,0,
0,0,0,0,0,0,0,0,0,0,0,0,0,0,0,0,
0,0,0,0,0,0,0,0,0,0,439,439,0,0,0,0,
0,0,0,0,0,0,0,0,0,0,0,0,0,0,0,0,
0,0,0,0,0,0,0,0,0,0,0,0,0,0,0,0,
0,0,0,0,0,0,0,0,0,0,0,0,0,0,0,0
            ],
            "inFront" : false
        },
        {
            "graphical_map" : [
                0,0,0,0,0,0,0,0,0,0,0,0,0,0,0,0,
0,0,0,0,0,0,0,0,0,0,0,0,0,0,0,0,
0,0,0,0,0,0,0,0,0,0,0,0,0,0,0,0,
0,0,0,0,0,0,0,0,0,0,0,0,0,0,0,0,
0,0,0,0,0,0,0,0,0,0,0,0,0,0,0,0,
0,0,0,0,0,0,0,0,0,0,0,0,0,0,0,0,
0,0,0,0,0,0,0,0,0,0,0,0,0,0,0,0,
0,0,0,0,0,0,0,0,0,0,0,0,0,0,0,0,
0,0,0,0,0,0,0,0,0,0,0,0,0,0,0,0,
0,0,0,0,0,0,0,0,0,0,0,0,0,0,0,0,
0,0,0,0,0,0,0,0,0,0,0,0,0,0,0,0,
0,0,0,0,0,0,0,0,0,0,0,0,0,0,0,0,
0,0,0,392,0,0,0,0,0,0,0,0,0,0,0,0,
0,0,0,400,0,0,237,0,0,0,0,0,0,0,0,0,
0,0,0,0,0,0,0,0,0,0,0,0,0,0,0,0,
0,0,0,0,0,0,0,0,0,0,0,0,0,0,0,0
            ],
            "inFront" : false
        }
    ],

    "collision_map" : [15,15,15,15,15,15,15,15,15,0,0,0,0,15,15,15,
        15,15,15,15,15,15,15,15,15,0,0,0,0,15,15,15,
        15,15,0,0,0,0,0,0,0,0,1,1,0,0,15,15,
        15,15,0,0,0,0,0,0,0,0,0,0,0,0,15,15,
        15,15,0,0,0,0,0,1,1,0,0,0,0,0,15,15,
        15,15,0,0,0,0,0,0,0,0,0,0,0,0,15,15,
        15,15,0,0,0,0,0,0,0,0,1,1,0,0,15,15,
        15,15,0,0,0,0,0,0,0,0,0,0,0,0,15,15,
        15,15,0,0,0,0,0,0,0,0,0,0,0,0,15,15,
        15,15,0,0,0,0,0,0,0,0,1,1,0,0,15,15,
        15,15,0,0,0,0,0,0,0,0,0,0,0,0,15,15,
        15,15,0,0,0,0,0,0,0,0,0,0,0,0,15,15,
        15,15,0,0,0,0,0,0,0,0,1,1,0,0,15,15,
        15,15,0,0,0,0,0,0,0,0,0,0,0,0,15,15,
        15,15,15,15,15,15,15,15,15,15,15,15,15,15,15,15,
        15,15,15,15,15,15,15,15,15,15,15,15,15,15,15,15],

    "doors" : [{ "x":288, "y":-16, "width":128, "height":32,
        "destination_zone":"01", "destination_x":-1, "destination_y":450 }],

    "columns" : 16,
    "rows" : 16,
    "rendered_columns" : 16,
    "rendered_rows" : 16,

    "id" : "00"
}