{
    "question_marks" : [],
    "lava" : [[2,14],[3,14],[12,14],[13,14]],
    "keys" : [],

    "layers" : [
        {
            "graphical_map" : [
                309,309,309,309,309,309,309,309,309,309,309,309,309,309,309,309,
                309,309,309,309,309,309,309,309,309,309,309,309,309,309,309,309,
                309,309,309,309,309,309,309,309,309,309,309,309,309,309,309,309,
                309,309,309,309,309,309,309,309,309,309,309,309,309,309,309,309,
                309,309,309,309,309,309,309,309,309,309,309,309,309,309,309,309,
                309,309,309,309,309,309,309,309,309,309,309,309,309,309,309,309,
                309,309,309,309,309,309,309,309,309,309,309,309,309,309,309,309,
                309,309,309,309,309,309,309,309,309,309,309,309,309,309,309,309,
                309,309,309,309,309,309,309,309,309,309,309,309,309,309,309,309,
                309,309,309,309,309,309,309,309,309,309,309,309,309,309,309,309,
                309,309,309,309,309,309,309,309,309,309,309,309,309,309,309,309,
                309,309,309,309,309,309,309,309,309,309,309,309,309,309,309,309,
                309,309,309,309,309,309,309,309,309,309,309,309,309,309,309,309,
                309,309,309,309,309,309,309,309,309,309,309,309,309,309,309,309,
                309,309,309,309,309,309,309,309,309,309,309,309,309,309,309,309,
                309,309,309,309,309,309,309,309,309,309,309,309,309,309,309,309
            ],
            "inFront" : false
        },
        {
            "graphical_map" : [
                253,241,241,241,241,241,241,241,241,0,0,0,0,241,241,261,
                258,249,249,249,249,249,249,249,249,0,0,0,0,249,249,252,
                258,249,0,0,0,0,0,0,0,0,0,0,0,0,249,252,
                258,249,0,0,0,0,0,0,0,0,0,0,0,0,249,252,
                0,0,0,0,0,0,0,0,0,0,0,0,0,249,249,252,
                258,249,0,0,0,0,0,0,0,0,0,0,0,249,249,252,
                258,249,249,249,747,0,0,0,0,0,0,0,0,0,249,252,
                258,249,249,249,249,0,0,0,0,0,0,0,0,249,249,252,
                258,249,249,0,0,0,0,0,0,0,0,0,0,0,249,252,
                258,249,0,0,0,0,0,0,0,0,0,0,0,249,249,252,
                258,249,0,0,0,0,0,0,0,0,0,0,0,249,249,252,
                258,249,0,0,0,0,0,0,0,0,0,0,0,0,249,252,
                258,249,0,0,0,747,0,0,249,249,747,0,0,0,249,252,
                258,249,0,0,249,249,249,249,249,249,249,249,0,0,249,252,
                258,249,0,0,249,249,249,249,249,249,249,249,0,0,249,252,
                247,255,255,255,255,255,255,255,255,255,255,255,255,255,255,248
            ],
            "inFront" : false
        },
        {
            "graphical_map" : [
                0,0,0,0,0,0,0,0,0,0,0,0,0,0,0,0,
                0,0,0,0,0,0,0,0,0,0,439,439,0,0,0,0,
                0,0,0,0,0,0,0,0,0,0,0,0,0,0,0,0,
                0,0,0,0,0,0,0,0,0,0,0,0,0,0,0,0,
                0,0,0,0,0,0,0,0,0,0,439,439,0,0,0,0,
                0,0,0,0,0,0,0,0,0,0,0,0,0,0,0,0,
                0,0,0,0,0,0,0,0,439,439,0,0,0,0,0,0,
                0,0,0,0,0,0,0,0,0,0,0,0,0,0,0,0,
                0,0,0,0,0,0,0,439,0,0,0,0,0,0,0,0,
                0,0,0,0,0,0,0,0,0,0,0,0,0,0,0,0,
                0,0,0,0,0,439,439,0,0,0,0,0,0,0,0,0,
                0,0,0,0,0,0,0,0,0,0,0,0,0,0,0,0,
                0,0,0,0,0,0,0,0,0,0,0,0,0,0,0,0,
                0,0,0,0,0,0,0,0,0,0,0,0,0,0,0,0,
                0,0,0,0,0,0,0,0,0,0,0,0,0,0,0,0,
                0,0,0,0,0,0,0,0,0,0,0,0,0,0,0,0
            ],
            "inFront" : false
        },
        {
            "graphical_map" : [
                0,0,0,0,0,0,0,0,0,0,0,0,0,0,0,0,
                0,0,0,0,0,0,0,0,0,0,0,0,0,0,0,0,
                0,0,0,0,0,0,0,0,0,0,0,0,0,0,0,0,
                0,0,0,0,0,0,0,0,0,0,0,0,0,0,0,0,
                0,0,0,0,0,0,0,0,0,0,0,0,0,0,0,0,
                0,0,0,0,0,0,0,0,0,0,0,0,0,0,0,0,
                0,0,0,0,0,0,0,0,0,0,0,0,0,0,0,0,
                0,0,0,0,0,0,0,0,0,0,0,0,0,0,0,0,
                0,0,0,0,0,0,0,0,0,0,0,0,0,0,0,0,
                0,0,0,0,0,0,0,0,0,0,0,0,0,0,0,0,
                0,0,0,0,0,0,0,0,0,0,0,0,0,0,0,0,
                0,0,0,0,0,0,0,0,0,0,0,0,0,0,0,0,
                0,0,0,0,0,0,0,0,0,0,0,0,0,0,0,0,
                0,0,0,0,0,0,0,0,0,0,0,0,0,0,0,0,
                0,0,0,0,0,0,0,0,0,0,0,0,0,0,0,0,
                0,0,0,0,0,0,0,0,0,0,0,0,0,0,0,0
            ],
            "inFront" : false
        }
    ],

    "collision_map" : [
        15,15,15,15,15,15,15,15,15,0,0,0,0,15,15,15,
        15,15,15,15,15,15,15,15,15,0,1,1,0,15,15,15,
        15,15,0,0,0,0,0,0,0,0,0,0,0,0,15,15,
        15,15,0,0,0,0,0,0,0,0,0,0,0,0,15,15,
        0,0,0,0,0,0,0,0,0,0,1,1,0,15,15,15,
        15,15,0,0,0,0,0,0,0,0,0,0,0,15,15,15,
        15,15,15,15,0,0,0,0,1,1,0,0,0,0,15,15,
        15,15,15,15,15,0,0,0,0,0,0,0,0,15,15,15,
        15,15,15,0,0,0,0,1,0,0,0,0,0,0,15,15,
        15,15,0,0,0,0,0,0,0,0,0,0,0,15,15,15,
        15,15,0,0,0,1,1,0,0,0,0,0,0,15,15,15,
        15,15,0,0,0,0,0,0,0,0,0,0,0,0,15,15,
        15,15,0,0,0,0,0,0,15,15,0,0,0,0,15,15,
        15,15,0,0,15,15,15,15,15,15,15,15,0,0,15,15,
        15,15,0,0,15,15,15,15,15,15,15,15,0,0,15,15,
        15,15,15,15,15,15,15,15,15,15,15,15,15,15,15,15
    ],

    "doors" : [{ "x":-16, "y":128, "width":32, "height":32,
        "destination_zone":"04", "destination_x":490, "destination_y":-1 },
        { "x":288, "y":-16, "width":128, "height":32,
            "destination_zone":"06", "destination_x":-1, "destination_y":430 }],

    "columns" : 16,
    "rows" : 16,

    "id" : "02"
}