{
    "question_marks" : [[8,13, "недавно здесь была проверка, и юные лаборанты в суете пролили реагенты (желтое, движется). Если ты не хочешь на вышмат, то можешь в них поплавать (не советую)"]],
    "lava" : [[2, 13],[3, 13],[4, 13]],
    "keys" : [],
    "notes" : [{ "x":96, "y":192, "width":32, "height":32, "text" : "здесь может быть ваша реклама"}],
    "layesrs" : [{
        "graphical_map" : [
            253,241,241,241,241,241,241,241,241,241,241,241,241,241,241,261,
258,249,249,249,249,249,249,249,249,249,249,249,249,249,249,252,
258,249,0,0,0,249,249,249,249,249,249,0,0,0,249,252,
258,249,0,0,0,249,249,249,249,249,0,0,0,0,249,252,
258,249,249,0,0,0,249,249,249,249,0,0,249,249,249,252,
258,249,249,0,0,0,0,0,0,0,0,0,0,249,249,252,
258,249,249,747,0,0,0,0,0,0,0,0,0,0,249,252,
258,249,249,249,0,0,0,0,0,0,0,0,0,0,0,0,
258,249,249,249,0,0,0,0,0,0,0,0,0,747,249,252,
258,249,249,249,0,0,0,0,0,0,0,0,0,249,249,252,
258,249,249,0,0,0,747,0,0,0,0,249,249,249,249,252,
258,249,0,0,0,249,249,249,0,0,0,0,249,249,249,252,
258,249,0,0,249,249,249,0,0,0,0,0,0,249,249,252,
258,249,249,249,249,249,0,0,0,0,0,0,0,0,249,252,
258,249,249,249,249,249,249,249,249,0,0,0,0,249,249,252,
247,255,255,255,255,255,255,255,255,0,0,0,0,255,255,248
        ],
        "inFront" : false
    }],
    "layers" : [
        {
            "graphical_map" : [309,309,309,309,309,309,309,309,309,309,309,309,309,309,309,309,
                309,309,309,309,309,309,309,309,309,309,309,309,309,309,309,309,
                309,309,309,309,309,309,309,309,309,309,309,309,309,309,309,309,
                309,309,309,309,309,309,309,309,309,309,309,309,309,309,309,309,
                309,309,309,309,309,309,309,309,309,309,309,309,309,309,309,309,
                309,309,309,309,309,309,309,309,309,309,309,309,309,309,309,309,
                309,309,309,309,309,309,309,309,309,309,309,309,309,309,309,309,
                309,309,309,309,309,309,309,309,309,309,309,309,309,309,309,309,
                309,309,309,309,309,309,309,309,309,309,309,309,309,309,309,309,
                309,309,309,309,309,309,309,309,309,309,309,309,309,309,309,309,
                309,309,309,309,309,309,309,309,309,309,309,309,309,309,309,309,
                309,309,309,309,309,309,309,309,309,309,309,309,309,309,309,309,
                309,309,309,309,309,309,309,309,309,309,309,309,309,309,309,309,
                309,309,309,309,309,309,309,309,309,309,309,309,309,309,309,309,
                309,309,309,309,309,309,309,309,309,309,309,309,309,309,309,309,
                309,309,309,309,309,309,309,309,309,309,309,309,309,309,309,309],
            "inFront" : false
        },
        {
            "graphical_map" : [
                253,241,241,241,241,241,241,241,241,241,241,241,241,241,241,261,
258,249,249,249,249,249,249,249,249,249,249,249,249,249,249,252,
258,249,0,0,0,249,249,249,249,249,249,0,0,0,249,252,
258,249,0,0,0,249,249,249,249,249,0,0,0,0,249,252,
258,249,249,0,0,0,249,249,249,249,0,0,249,249,249,252,
258,249,249,0,0,0,0,0,0,0,0,0,0,249,249,252,
258,249,249,747,0,0,0,0,0,0,0,0,0,0,249,252,
258,249,249,249,0,0,0,0,0,0,0,0,0,0,0,0,
258,249,249,249,0,0,0,0,0,0,0,0,0,747,249,252,
258,249,249,249,0,0,0,0,0,0,0,0,0,249,249,252,
258,249,249,0,0,0,747,0,0,0,0,249,249,249,249,252,
258,249,0,0,0,249,249,249,0,0,0,0,249,249,249,252,
258,249,0,0,249,249,249,0,0,0,0,0,0,249,249,252,
258,249,0,0,0,249,0,0,0,0,0,0,0,0,249,252,
258,249,249,249,249,249,249,249,249,0,0,0,0,249,249,252,
247,255,255,255,255,255,255,255,255,0,0,0,0,255,255,248
            ],
            "inFront" : false
        },
        {
            "graphical_map" : [
                0,0,0,0,0,0,0,0,0,0,0,0,0,0,0,0,
0,0,0,0,0,0,0,0,0,0,0,0,0,0,0,0,
0,0,0,0,0,0,0,0,0,0,0,0,0,0,0,0,
0,0,0,0,0,0,0,0,0,0,0,0,0,0,0,0,
0,0,0,0,0,0,0,0,0,0,0,0,0,0,0,0,
0,0,0,0,0,0,0,0,0,0,0,439,0,0,0,0,
0,0,0,0,0,0,0,0,0,0,0,0,0,0,0,0,
0,0,0,0,0,0,439,0,0,0,439,0,0,0,0,0,
0,0,0,0,0,0,0,0,0,0,0,0,0,0,0,0,
0,0,0,0,0,0,0,439,439,0,0,0,0,0,0,0,
0,0,0,0,0,0,0,0,0,0,0,0,0,0,0,0,
0,0,0,0,0,0,0,0,0,0,0,0,0,0,0,0,
0,0,0,0,0,0,0,0,0,439,439,0,0,0,0,0,
0,0,0,0,0,0,0,0,0,0,0,0,0,0,0,0,
0,0,0,0,0,0,0,0,0,0,0,0,0,0,0,0,
0,0,0,0,0,0,0,0,0,0,439,439,0,0,0,0
            ],
            "inFront" : false
        },
        {
            "graphical_map" : [
                0,0,0,0,0,0,0,0,0,0,0,0,0,0,0,0,
0,0,0,0,0,0,0,0,0,0,0,0,0,0,0,0,
0,0,0,0,0,0,0,0,0,0,0,0,0,0,0,0,
0,0,0,0,0,0,0,0,0,0,0,0,0,0,0,0,
0,0,0,0,0,0,0,0,0,0,0,0,0,0,0,0,
0,0,0,0,0,0,0,0,0,0,0,0,0,0,0,0,
0,0,0,0,0,0,0,0,0,0,0,0,0,0,0,0,
0,0,0,0,0,0,0,0,0,0,0,0,0,0,0,0,
0,0,0,0,0,0,0,0,0,0,0,0,0,0,0,0,
0,0,0,0,0,0,0,0,0,0,0,0,0,0,0,0,
0,0,0,0,0,0,0,0,0,0,0,0,0,0,0,0,
0,0,0,0,0,0,0,0,0,0,0,0,0,0,0,0,
0,0,0,0,0,0,0,0,0,0,0,0,0,0,0,0,
0,0,0,0,0,0,0,0,237,0,0,0,0,0,0,0,
0,0,0,0,0,0,0,0,0,0,0,0,0,0,0,0,
0,0,0,0,0,0,0,0,0,0,0,0,0,0,0,0
            ],
            "inFront" : false
        }
    ],

    "collision_map" : [15,15,15,15,15,15,15,15,15,15,15,15,15,15,15,15,
        15,15,15,15,15,15,15,15,15,15,15,15,15,15,15,15,
        15,15,0,0,0,15,15,15,15,15,15,0,0,0,15,15,
        15,15,0,0,0,15,15,15,15,15,0,0,0,0,15,15,
        15,15,15,0,0,0,15,15,15,15,0,0,15,15,15,15,
        15,15,15,0,0,0,0,0,0,0,0,1,0,15,15,15,
        15,15,15,0,0,0,0,0,0,0,0,0,0,0,15,15,
        15,15,15,15,0,0,1,0,0,0,1,0,0,0,0,0,
        15,15,15,15,0,0,0,0,0,0,0,0,0,0,15,15,
        15,15,15,15,0,0,0,1,1,0,0,0,0,15,15,15,
        15,15,15,0,0,0,0,0,0,0,0,15,15,15,15,15,
        15,15,0,0,0,15,15,15,0,0,0,0,15,15,15,15,
        15,15,0,0,15,15,15,0,0,1,1,0,0,15,15,15,
        15,15,0,0,0,15,0,0,0,0,0,0,0,0,15,15,
        15,15,15,15,15,15,15,15,15,0,0,0,0,15,15,15,
        15,15,15,15,15,15,15,15,15,0,1,1,0,15,15,15],

    "doors" : [{ "x":288, "y":496, "width":128, "height":32,
        "destination_zone":"00", "destination_x":-1, "destination_y":20 },
        { "x":496, "y":224, "width":32, "height":32,
            "destination_zone":"02", "destination_x":20, "destination_y":-1 }],

    "columns" : 16,
    "rows" : 16,

    "id" : "01"
}