{
    "question_marks" : [[7, 11, "Иногда на партах можно увидеть какие-то ключи. на самом деле эти какие-то ключи открывают какие-то комнаты (какие именно никто не знает, так как это хим корпус). Также в некоторые кабинеты можно добраться только войдя в другие. На этом принципе и был основан этот корпус"]],
    "lava" : [],
    "keys" : [{ "x":352, "y":352, "width":32, "height":32,
        "destination_zone":"04"}],
    "notes" : [{ "x":160, "y":320, "width":32, "height":32, "text" : "project - проект, IT - ИТ, proffesion - профессия, printer - принтер"}],

    "layers" : [
        {
            "graphical_map" : [
                309,309,309,309,309,309,309,309,309,309,309,309,309,309,309,309,
                309,309,309,309,309,309,309,309,309,309,309,309,309,309,309,309,
                309,309,309,309,309,309,309,309,309,309,309,309,309,309,309,309,
                309,309,309,309,309,309,309,309,309,309,309,309,309,309,309,309,
                309,309,309,309,309,309,309,309,309,309,309,309,309,309,309,309,
                309,309,309,309,309,309,309,309,309,309,309,309,309,309,309,309,
                309,309,309,309,309,309,309,309,309,309,309,309,309,309,309,309,
                309,309,309,309,309,309,309,309,309,309,309,309,309,309,309,309,
                309,309,309,309,309,309,309,309,309,309,309,309,309,309,309,309,
                309,309,309,309,309,309,309,309,309,309,309,309,309,309,309,309,
                309,309,309,309,309,309,309,309,309,309,309,309,309,309,309,309,
                309,309,309,309,309,309,309,309,309,309,309,309,309,309,309,309,
                309,309,309,309,309,309,309,309,309,309,309,309,309,309,309,309,
                309,309,309,309,309,309,309,309,309,309,309,309,309,309,309,309,
                309,309,309,309,309,309,309,309,309,309,309,309,309,309,309,309,
                309,309,309,309,309,309,309,309,309,309,309,309,309,309,309,309
            ],
            "inFront" : false
        },
        {
            "graphical_map" : [
                253,241,241,241,241,241,241,241,0,0,0,241,241,241,241,261,
                258,249,249,249,249,249,249,0,0,0,249,249,249,249,249,252,
                258,249,249,249,249,249,0,0,0,0,0,0,0,0,249,252,
                258,249,249,249,0,0,0,0,0,0,0,0,0,249,249,252,
                258,249,249,0,0,0,0,0,0,0,0,0,249,249,249,252,
                258,249,249,249,716,0,0,0,0,0,0,0,249,249,249,252,
                258,249,249,0,724,0,0,0,0,0,0,0,249,249,249,252,
                258,249,249,249,249,0,0,0,0,0,0,0,249,249,249,252,
                258,249,249,249,249,0,0,0,0,0,0,0,249,249,249,252,
                258,249,0,0,0,0,0,0,0,0,0,0,0,249,249,252,
                258,249,0,0,0,709,709,0,0,0,0,0,0,249,249,252,
                258,249,0,709,0,249,249,0,0,0,0,709,716,249,249,252,
                258,249,0,249,249,249,249,249,763,0,249,249,724,249,249,252,
                258,249,249,249,249,249,249,249,249,249,249,249,249,249,249,252,
                258,249,249,249,249,249,249,249,249,249,249,249,249,249,249,252,
                247,255,255,255,255,255,255,255,255,255,255,255,255,255,255,248
            ],
            "inFront" : false
        },
        {
            "graphical_map" : [
                0,0,0,0,0,0,0,0,0,0,0,0,0,0,0,0,
                0,0,0,0,0,0,0,0,0,0,0,0,0,0,0,0,
                0,0,0,0,0,0,0,0,0,0,0,0,0,0,0,0,
                0,0,0,0,0,0,0,0,439,439,0,0,0,0,0,0,
                0,0,0,0,0,0,0,0,0,0,0,0,0,0,0,0,
                0,0,0,0,0,0,0,0,0,0,0,0,0,0,0,0,
                0,0,0,0,0,0,0,0,0,0,439,439,0,0,0,0,
                0,0,0,0,0,0,0,0,0,0,0,0,0,0,0,0,
                0,0,0,0,0,0,0,0,0,439,439,0,0,0,0,0,
                0,0,0,0,0,0,0,0,0,0,0,0,0,0,0,0,
                0,0,0,0,0,0,0,0,0,439,0,0,0,0,0,0,
                0,0,0,0,0,0,0,0,0,0,0,0,0,0,0,0,
                0,0,0,0,0,0,0,0,0,0,0,0,0,0,0,0,
                0,0,0,0,0,0,0,0,0,0,0,0,0,0,0,0,
                0,0,0,0,0,0,0,0,0,0,0,0,0,0,0,0,
                0,0,0,0,0,0,0,0,0,0,0,0,0,0,0,0
            ],
            "inFront" : false
        },
        {
            "graphical_map" : [
                0,0,0,0,0,0,0,0,0,0,0,0,0,0,0,0,
                0,0,0,0,0,0,0,0,0,0,0,0,0,0,0,0,
                0,0,0,0,0,0,0,0,0,0,0,0,0,0,0,0,
                0,0,0,0,0,0,0,0,0,0,0,0,0,0,0,0,
                0,0,0,0,0,0,0,0,0,0,0,0,0,0,0,0,
                0,0,0,0,0,0,0,0,0,0,0,0,0,0,0,0,
                0,0,0,0,0,0,0,0,0,0,0,0,0,0,0,0,
                0,0,0,0,0,0,0,0,0,0,0,0,0,0,0,0,
                0,0,0,0,0,0,0,0,0,0,0,0,0,0,0,0,
                0,0,0,0,0,0,0,0,0,0,0,0,0,0,0,0,
                0,0,0,0,0,0,0,0,0,0,0,0,0,0,0,0,
                0,0,0,0,0,0,0,237,0,0,0,0,0,0,0,0,
                0,0,0,0,0,0,0,0,0,0,0,0,0,0,0,0,
                0,0,0,0,0,0,0,0,0,0,0,0,0,0,0,0,
                0,0,0,0,0,0,0,0,0,0,0,0,0,0,0,0,
                0,0,0,0,0,0,0,0,0,0,0,0,0,0,0,0
            ],
            "inFront" : false
        }
    ],

    "collision_map" : [
        15,15,15,15,15,15,15,15,0,0,0,15,15,15,15,15,
        15,15,15,15,15,15,15,0,0,0,15,15,15,15,15,15,
        15,15,15,15,15,15,0,0,0,0,0,0,0,0,15,15,
        15,15,15,15,0,0,0,0,1,1,0,0,0,15,15,15,
        15,15,15,0,0,0,0,0,0,0,0,0,15,15,15,15,
        15,15,15,15,0,0,0,0,0,0,0,0,15,15,15,15,
        15,15,15,0,0,0,0,0,0,0,1,1,15,15,15,15,
        15,15,15,15,15,0,0,0,0,0,0,0,15,15,15,15,
        15,15,15,15,15,0,0,0,0,1,1,0,15,15,15,15,
        15,15,0,0,0,0,0,0,0,0,0,0,0,15,15,15,
        15,15,0,0,0,0,0,0,0,1,0,0,0,15,15,15,
        15,15,0,0,0,15,15,0,0,0,0,0,0,15,15,15,
        15,15,0,15,15,15,15,15,0,0,15,15,0,15,15,15,
        15,15,15,15,15,15,15,15,15,15,15,15,15,15,15,15,
        15,15,15,15,15,15,15,15,15,15,15,15,15,15,15,15,
        15,15,15,15,15,15,15,15,15,15,15,15,15,15,15,15
    ],


    "doors" : [{ "x":256, "y":-16, "width":96, "height":32,
        "destination_zone":"02", "destination_x":-1, "destination_y":420 }],

    "columns" : 16,
    "rows" : 16,

    "id" : "03"
}