{
    "question_marks" : [],
    "lava" : [],
    "keys" : [],
    "notes" : [{ "x":384, "y":128, "width":32, "height":32, "text" : "У меня 90+ баллов по English. У меня жизнь состоялась! © Саша "}],

    "layers" : [
        {
            "graphical_map" : [
                309,309,309,309,309,309,309,309,309,309,309,309,309,309,309,309,
                309,309,309,309,309,309,309,309,309,309,309,309,309,309,309,309,
                309,309,309,309,309,309,309,309,309,309,309,309,309,309,309,309,
                309,309,309,309,309,309,309,309,309,309,309,309,309,309,309,309,
                309,309,309,309,309,309,309,309,309,309,309,309,309,309,309,309,
                309,309,309,309,309,309,309,309,309,309,309,309,309,309,309,309,
                309,309,309,309,309,309,309,309,309,309,309,309,309,309,309,309,
                309,309,309,309,309,309,309,309,309,309,309,309,309,309,309,309,
                309,309,309,309,309,309,309,309,309,309,309,309,309,309,309,309,
                309,309,309,309,309,309,309,309,309,309,309,309,309,309,309,309,
                309,309,309,309,309,309,309,309,309,309,309,309,309,309,309,309,
                309,309,309,309,309,309,309,309,309,309,309,309,309,309,309,309,
                309,309,309,309,309,309,309,309,309,309,309,309,309,309,309,309,
                309,309,309,309,309,309,309,309,309,309,309,309,309,309,309,309,
                309,309,309,309,309,309,309,309,309,309,309,309,309,309,309,309,
                309,309,309,309,309,309,309,309,309,309,309,309,309,309,309,309
            ],
            "inFront" : false
        },
        {
            "graphical_map" : [
                253,241,241,241,241,241,241,241,241,241,241,241,241,241,241,261,
                258,249,249,249,0,0,0,0,0,249,249,249,249,249,249,252,
                258,249,249,249,0,0,0,0,0,0,0,0,0,0,249,252,
                258,249,249,249,249,249,0,0,0,0,0,0,0,0,249,252,
                258,249,0,0,0,0,0,0,0,0,0,0,747,0,249,252,
                258,249,0,0,0,0,0,0,0,0,0,0,249,0,249,252,
                0,0,0,0,0,0,811,0,0,0,0,0,249,249,249,252,
                258,249,0,0,0,0,0,0,0,0,0,0,249,249,249,252,
                258,249,0,0,0,0,0,0,0,0,0,0,0,249,249,252,
                258,249,0,0,0,0,0,0,0,0,0,0,0,249,249,252,
                258,249,0,0,0,0,0,0,0,0,0,0,0,249,249,252,
                258,249,747,0,0,0,0,0,0,0,0,0,0,249,249,252,
                258,249,249,0,0,0,0,0,0,0,0,0,0,0,249,252,
                258,249,249,249,249,249,0,747,0,0,0,0,0,0,249,252,
                258,249,249,249,249,249,249,249,249,0,0,0,0,249,249,252,
                247,255,255,255,255,255,255,255,255,0,0,0,0,255,255,248
            ],
            "inFront" : false
        },
        {
            "graphical_map" : [
                0,0,0,0,0,0,0,0,0,0,0,0,0,0,0,0,
                0,0,0,0,0,0,0,0,0,0,0,0,0,0,0,0,
                0,0,0,0,0,0,0,0,0,0,0,0,0,0,0,0,
                0,0,0,0,0,0,0,439,439,0,0,0,0,0,0,0,
                0,0,0,0,0,0,0,0,0,0,0,0,0,0,0,0,
                0,0,0,0,0,0,0,0,0,0,439,439,0,0,0,0,
                0,0,0,0,0,0,0,0,0,0,0,0,0,0,0,0,
                0,0,0,0,0,0,0,0,0,0,0,0,0,0,0,0,
                0,0,0,439,0,0,0,0,0,0,439,439,0,0,0,0,
                0,0,0,0,0,0,0,0,0,0,0,0,0,0,0,0,
                0,0,0,0,0,439,439,0,0,0,0,0,0,0,0,0,
                0,0,0,0,0,0,0,0,0,0,439,439,0,0,0,0,
                0,0,0,0,0,0,0,0,0,0,0,0,0,0,0,0,
                0,0,0,0,0,0,0,0,0,0,0,0,0,0,0,0,
                0,0,0,0,0,0,0,0,0,0,439,439,0,0,0,0,
                0,0,0,0,0,0,0,0,0,0,0,0,0,0,0,0
            ],
            "inFront" : false
        },
        {
            "graphical_map" : [
                0,0,0,0,0,0,0,0,0,0,0,0,0,0,0,0,
                0,0,0,0,0,520,0,0,0,0,0,0,0,0,0,0,
                0,0,0,0,0,528,0,0,0,0,0,0,0,0,0,0,
                0,0,0,0,0,0,0,0,0,0,0,0,0,0,0,0,
                0,0,0,0,0,0,0,0,0,0,0,0,0,0,0,0,
                0,0,0,0,0,0,0,0,0,0,0,0,0,0,0,0,
                0,0,0,0,0,0,0,0,0,0,0,0,0,0,0,0,
                0,0,0,0,0,0,0,0,0,0,0,0,0,0,0,0,
                0,0,0,0,0,0,0,0,0,0,0,0,0,0,0,0,
                0,0,0,0,0,0,0,0,0,0,0,0,0,0,0,0,
                0,0,0,0,0,0,0,0,0,0,0,0,0,0,0,0,
                0,0,0,0,0,0,0,0,0,0,0,0,0,0,0,0,
                0,0,0,0,0,0,0,0,0,0,0,0,0,0,0,0,
                0,0,0,0,0,0,0,0,0,0,0,0,0,0,0,0,
                0,0,0,0,0,0,0,0,0,0,0,0,0,0,0,0,
                0,0,0,0,0,0,0,0,0,0,0,0,0,0,0,0
            ],
            "inFront" : false
        }
    ],

    "collision_map" : [
        15,15,15,15,15,15,15,15,15,15,15,15,15,15,15,15,
        15,15,15,15,0,0,0,0,0,15,15,15,15,15,15,15,
        15,15,15,15,0,0,0,0,0,0,0,0,0,0,15,15,
        15,15,15,15,15,15,0,1,1,0,0,0,0,0,15,15,
        15,15,0,0,0,0,0,0,0,0,0,0,0,0,15,15,
        15,15,0,0,0,0,0,0,0,0,1,1,15,0,15,15,
        0,0,0,0,0,0,0,0,0,0,0,0,15,15,15,15,
        15,15,0,0,0,0,0,0,0,0,0,0,15,15,15,15,
        15,15,0,1,0,0,0,0,0,0,1,1,0,15,15,15,
        15,15,0,0,0,0,0,0,0,0,0,0,0,15,15,15,
        15,15,0,0,0,1,1,0,0,0,0,0,0,15,15,15,
        15,15,0,0,0,0,0,0,0,0,1,1,0,15,15,15,
        15,15,15,0,0,0,0,0,0,0,0,0,0,0,15,15,
        15,15,15,15,15,15,0,0,0,0,0,0,0,0,15,15,
        15,15,15,15,15,15,15,15,15,0,1,1,0,15,15,15,
        15,15,15,15,15,15,15,15,15,0,0,0,0,15,15,15
    ],

    "doors" : [{ "x":-16, "y":192, "width":32, "height":32,
        "destination_zone":"07", "destination_x":490, "destination_y":-1 },
        { "x":288, "y":496, "width":128, "height":32,
            "destination_zone":"05", "destination_x":-1, "destination_y":20 },
        { "x":160, "y":32, "width":32, "height":64,
            "destination_zone":"09", "destination_x":288, "destination_y":416, "needs_key" : true, "zone" : "09"}],

    "columns" : 16,
    "rows" : 16,

    "id" : "02"
}